..o.x...o..o.....x..
..o.....x.x.........
.x....o.o.x...o....o
....o.......o......x
oox...x..xxoxx...xo.
......x......x......
o...o....o..o....x.o
...x.......x.x.....o
......x.x....o......
.x.x.....o.......x.x
ox.........xx....xox
.......xo...o....o.o
.o.x.o...x...x.o.xo.
xx.......oxx.x......
..@....o...xx.......
.xoxo.x.o...o...ox.o
o.o..o......o...o...
..o..x.....o.o.o..o.
..o..........x..o..x
.o...o.x..x.x..x.o..