...o.x......x.o...o.
.o...x.o.......xo..x
......ox.....x.o....
x..x.....xx......o..
.....x.x..o.o.xo..xo
xo.o.o...x.o.xx.x...
.......ox...xx@x.xx.
...xox..x.x........x
.ooo.x..........o...
.o.....o...x.x...x..
o.....o...o.o.xxo.xo
..xo.o..o...........
..x.x......o.....oo.
..o.o......o.x..xx..
..xxo.....ox.xxo.x..
x....o.....oo...o.x.
....o.x....x....x.o.
xo.o...o..x...o..oo.
..xx...o.xo.......x.
........xo....x....o