.......x............
...o......x.....x...
........oo.o........
....o..o...x.....o..
...x.............o.o
.............o......
...xx....o..........
............x.......
...........x........
.......o..oo.......x
....x.............x.
..ox..x.......o.x.ox
.ox.o.o.x...........
.........ooo......x.
oo.....o.........x..
.x.....o.x....o.....
.....x...........x..
..xxx@....xx.x......
........ox.......x.x
............o.xo....