x..x.x.o..o.x..o....
.....x.........o....
..o..o@oox.o.o......
..x..oxx.......o..x.
o....x..o.o........o
o..........x........
....x.....x..o....o.
.......o.........x..
.o.....x............
o....oo..o....o..o..
...........o....o.xx
....o.x.....o.......
.o.......xo.........
........o.........ox
...............ox...
..o.ox......o.....x.
...o..........x.....
..............x.....
x.o...x.o......oo...
..o.o.o...ox..o...x.