..........o.........
...o...x.o@oo..o....
o....x...o....o...xx
..o...o.x....o....x.
.....oxo............
...x...o............
..x.o........o......
...........x.xxo....
...oo....x..o.......
o...oo.............x
o....o....x...x..o..
...o................
.o.xx.......o.......
.x..x.....x....o...o
x.x....o....xx......
..x.o...x...o.x.x...
...x...ooxx........o
..x.....x...xo....x.
.oo......oo...o.....
o...xx....o..x.x...x