........o..x....x.oo
x...o.......o..x..o.
......oo...x..o.....
..x...x....oo....x..
.....x...........x..
..................o.
........o...........
..o...o.ox....o.....
...........x.......x
..x..x.o....x..o..x.
............ox......
.....o.x............
...x.o..o.ox...o.o..
....o.o..x.........x
.............o..xx..
xx...ox......xo.....
...ox@....o...o.....
....x..........x....
.x.x.o..............
....o.o..o..........