....................
....................
....................
.......ooo..........
......o...o.........
......o...o.........
......o...o.........
.......ooo..........
........o...........
........o...........
.....ooooooo........
........o...........
........o...........
.......o.o..........
......o...o.........
.....o.....o........
....................
....................
....@xxxx@.........
....................