.o...o...o..........
..o..o..o...........
...o.o.o............
....ooo.............
.oooo.oooo..........
....ooo.............
...o.o.o............
..o..o..o...........
.o...o...o..........
....................
....................
....................
....................
....................
....................
....................
....................
....................
....................
.............oxxxx@o